1	1	1	1	1	1	1	1	1	1
1	0	0	48	0	0	0	26	26	1
1	1	1	0	0	0	0	0	0	1
1	53	1	1	1	1	0	0	1	1
1	1	1	0	0	0	0	0	0	1
1	0	1	0	0	0	0	0	0	1
1	0	0	26	0	0	0	51	1	1
1	0	0	0	27	0	28	0	0	1
1	0	19	0	0	0	0	0	0	1
1	1	1	1	1	1	1	1	1	1
