30	30	30	30	30	30	30	30	30	30	30	30
30	1	1	1	1	1	1	1	1	1	1	30
30	1	53	1	1	1	1	48	0	1	1	30
30	1	1	1	0	0	0	0	0	0	1	30
30	1	0	1	0	0	0	0	0	0	1	30
30	1	0	0	26	0	0	0	51	1	1	30
30	1	0	0	0	27	0	28	0	0	1	30
30	1	0	19	0	0	0	0	0	0	1	30
30	1	1	1	1	1	1	1	1	1	1	30
30	30	30	30	30	30	30	30	30	30	30	30
